The Road to Wigan Pier - by George Orwell
The Wind in the Willows - by Kenneth Grahame
The Brothers Karamazov - by Fyodor Dostoevsky
The Scarlet Letter - by Nathaniel Hawthorne
The Adventures of Sherlock Holmes - by Arthur Conan Doyle
The War of the Worlds - by H.G. Wells
The Sun Also Rises - by Ernest Hemingway
The Secret Life of Bees - by Sue Monk Kidd
The Bell Jar - by Sylvia Plath
The Jungle Book - by Rudyard Kipling
The Time Machine - by H.G. Wells
The Joy Luck Club - by Amy Tan
The Road Less Traveled - by M. Scott Peck
The Girl on the Train - by Paula Hawkins
The Hound of the Baskervilles - by Arthur Conan Doyle
The Brothers Grimm Fairy Tales - by Jacob and Wilhelm Grimm
The Art of War - by Sun Tzu
The Stand - by Stephen King
The Metamorphosis - by Franz Kafka
The Three Musketeers - by Alexandre Dumas
The Secret Garden - by Frances Hodgson Burnett
The Call of the Wild - by Jack London
The Handmaid's Tale - by Margaret Atwood
The Color Purple - by Alice Walker
The Martian - by Andy Weir
The Glass Castle - by Jeannette Walls
The Spy Who Came in from the Cold - by John le Carré
The Fault in Our Stars - by John Green
The Girl on the Train - by Paula Hawkins
The Name of the Wind - by Patrick Rothfuss
The Silence of the Girls - by Pat Barker
The Lovely Bones - by Alice Sebold
The Fountainhead - by Ayn Rand
The Help - by Kathryn Stockett
The Gruffalo - by Julia Donaldson
The Lost Symbol - by Dan Brown
The Martian Chronicles - by Ray Bradbury
The Night Circus - by Erin Morgenstern
The Perks of Being a Wallflower - by Stephen Chbosky
The Power of One - by Bryce Courtenay
The Secret History - by Donna Tartt
The Secret of NIMH - by Robert C. O'Brien
The Secret Sharer - by Joseph Conrad
The Silver Chair - by C.S. Lewis
The Sound and the Fury - by William Faulkner
The Stranger - by Albert Camus
The Tale of Peter Rabbit - by Beatrix Potter
The Tenant of Wildfell Hall - by Anne Brontë
The Thing Around Your Neck - by Chimamanda Ngozi Adichie
The Time Traveler's Wife - by Audrey Niffenegger
